03030303
10101010
01010101
10101010
01010101
10101010
01010101
20101010